2017/05/03 22:38:22 

10111000000011111011101111000
11101011111010001010101001000
00001010001010111010111001100
11101011011010100010000000111
10111001010010111010000000001
10000111010010001010001111001
10011100010010111010001001001
11110000110010100010001001111
00000000100010100110111000000
01111111100010111100100011100
01000000001110000000111110100
01011111111000001110000000111
01110000000000101011111100001
00000000000011111000000111111
00111101110010000001110000000
00100101011110111111010111111
00110111000000100000010100001
00010000000000110011110100001
11110111011110010010000100001
10000101010010010011111100111
10111101010010011000000000100
11100001010010001000111000111
00000001010011101000101000001
01111111010000101000101111111
01000000010111101100100000000
01110000010100011000101111100
00010111110101110000111000100
00011100000111000000000000100
00000000000000000000000000111
