2017/05/03 22:28:22 

10000000000000000000000000000
10000000000000000000000000000
10000000000000000000000000000
11111111111111110000000000000
00000000000000010000000000000
00000000000000010000000000000
00000000000000010000000000000
00000000000000011000000000000
00000000000000010000000000000
00000000000000010000000000000
00000000000000011000000000000
00000000000000010000000000000
00000000000000010000000000000
00000000000000010000000000000
00000000000000010000000000000
00000000000000010000000000000
00000000000000010000000000000
00000000000000010000000000000
00000000000000010000000000000
00000000000000010000000000000
00000000000000010000000000000
00000000000000010000000000000
00000000000000010000000000000
00000000000000010000000000000
00000000000000011111111111110
00000000000000010000000000010
00000000000000000000000000010
00000000000000000000000000010
00000000000000000000000000011
