2017/05/03 22:57:07 

11111111111100000000000000000
10000000000100000000000000000
10000000000100000000000000000
10000000000100000000000000000
11111111111100000000000000000
10001000000000000000000000000
10000100000000000000000000000
10000110000000000000000000000
10000010000000000000000000000
10000010000000000000000000000
11111111111100000000000000000
10000001000000000000000000000
10000001100000000000000000000
10000000100000000000000000000
10000000110000000000000000100
10000000010000000000010000100
11100000011000000010001000100
11000000001000001111000000100
00000000001110011101000000100
00000000000111110001100000100
00000000000000000000110001100
00000000000000000000011001000
00000000000000000000001001000
00000000000000000000001111000
00000000000000000000011010000
00000000000000000000110011000
00000000000000000001100001100
00000000000000000110000000110
00000000000000001000000000011
