2017/05/08 21:57:50 

11111000000000000000000000000
00001000000000000000000000000
00001000000000000000000000000
00001000000000000000000000000
00001000000000000000000000000
00001000000000000000000000000
00001000000000000000000000000
00001000000000000000000000000
00001000000000000000000000000
00001000000000000000000000000
00001111000000000000000000000
00000001000000000000000000000
00000001000000000000000000000
00000001000000000000001111111
00000001000000000000001000001
00000001000000000000001000001
00000001000000000000001000001
00000001111111111100001000001
00000000000000000100001000001
00000000000000000100001000001
00000000000000000100001000001
00000000000000011100001000001
00000000000000010000001000001
00000000000000010000001000001
00000000000000010000001000001
00000000000011110000001000001
00000000000010000000001000001
00000000000011111111111000001
00000000000000000000000000001
