2017/05/08 22:28:50 

11100000000000000000000000000
00100000000000000000000000000
00100000000000000000000000000
00100000000000000000000000000
00100000000000000000000000000
00100000000000000000000000000
00100000000000000000000000000
00100000000000000000000000000
00100000000000000000000000000
00100000000000000000000000000
00100000000000000000000000000
00100000000000000000000000000
00100000000000000000000000000
00100000000000000000000000000
00100000000000000000000000000
00100000000000000000000000000
00100000000000000000000000000
00100000000000000000000000000
00111110000000000000000000000
00000010000000000000000000000
00000010000000000000000000000
00000011111111111110000000000
00000000000000000010000000000
00000000000000000010000000000
00000000000000000010000000000
00000000000000000010000000000
00000000000000000010000000000
00000000000000000011100000000
00000000000000000000111111111
